9
9
000000000
031121132
021103022
021122102
011101110
031321112
022023102
030102112
011101110
